# Context Descs
CtxPrayDesc=Beten
CtxAttackDesc=Angreifen
CtxDefendDesc=Verteidigen
CtxGuardDesc=Bewachen
CtxArmDesc=Bewaffnen
CtxUnbuckleDesc=Ablegen
CtxNoItemsToUnbuckle=Keine Gegenstände angelegt
CtxUnbuckleItem=%s ablegen

# Control Descs
CtrlInventoryDesc=Inventar auswählen
CtrlActivateDesc=Ablegen

# Messages
MsgWatch=%d Uhr und alles ist %s.
MsgWatchStateWell=gut
MsgWatchStateBad=arrrrrgghhhh
MsgNoEnemy=Kein Angriffsziel!
MsgNoArrow=Kein Pfeil.
MsgNoBullet=Keine Munition.
MsgNoSpear=Kein Speer.
MsgNoWeapons=Keine Waffen.
MsgArmed=Bewaffnet.
MsgEnemyDeath=%s erledigt.
MsgEnemyHostChanged=%s gehört|jetzt zu uns.

# Wunder
MsgNotEnoughEnergy=Nicht genug Karmaenergie
MnuNoSpells=Keine Wunder vorhanden.
MnuCast=Wunder:
CtxMagicDesc=Wunder
MsgDelay=Noch nicht wieder bereit!
MsgDelayFinished=%s wieder verfügbar!