# Context Descs
CtxPrayDesc=Pray
CtxAttackDesc=Attack
CtxDefendDesc=Defend
CtxGuardDesc=Guard
CtxArmDesc=Arm
CtxUnbuckleDesc=Unbuckle
CtxNoItemsToUnbuckle=No items buckled
CtxUnbuckleItem=Unbuckle %s

# Control Descs
CtrlInventoryDesc=Shift inventory
CtrlActivateDesc=Unbuckle

# Messages
MsgWatch=%d o'clock and all's %s.
MsgWatchStateWell=well
MsgWatchStateBad=arrrrrgghhhh
MsgNoEnemy=No attack target!
MsgNoArrow=No Arrow!
MsgNoBullet=No bullet!
MsgNoSpear=D'oh! No spear!
MsgNoWeapons=Ugh! No weapons.
MsgArmed=I'm armed.
MsgEnemyDeath=%s exterminated.
MsgEnemyHostChanged=%s is|now confederated.

# Wonders
MsgNotEnoughEnergy=Not enough karmaenergy
MnuNoSpells=No wonders
MnuCast=Wonder:
CtxMagicDesc=Cast wonders
MsgDelay=Not yet ready!
MsgDelayFinished=%s can be used again!